#CELL 0 9
16	1888	304	5	0	9	199
16	1904	304	5	0	9	134
16	1920	304	5	0	9	18
3	1866	295	4	6	2	0	9	127
#CELL 0 1
18	368	320	16	0	1	67
16	336	304	5	0	1	183
16	352	304	5	0	1	109
16	368	304	5	0	1	9
#CELL 0 10
5	2032	249	22	1	10	0	10	21
3	1984	300	4	2	2	0	10	110
#CELL 0 2
18	368	320	16	0	2	67
16	416	272	5	0	2	188
16	432	272	5	0	2	22
16	448	272	5	0	2	146
#CELL 0 3
18	624	304	16	0	3	162
9	608	288	2	1	1	0	3	53
9	624	288	2	1	1	0	3	68
9	640	288	2	1	1	3	0	3	147
9	656	288	2	1	1	0	3	44
9	752	320	2	1	1	0	3	37
#CELL 0 6
18	1200	320	16	0	6	81
9	1184	304	2	1	1	0	6	137
9	1200	304	2	1	1	0	6	82
9	1216	304	2	1	1	0	6	33
9	1232	304	2	1	1	0	6	115
9	1232	288	2	1	1	3	0	6	58
16	1328	288	5	0	6	13
16	1344	288	5	0	6	168
16	1360	288	5	0	6	100
#CELL 0 7
18	1552	304	16	0	7	195
9	1392	304	2	1	1	0	7	177
9	1408	304	2	1	1	0	7	186
9	1424	304	2	1	1	0	7	72
9	1536	288	2	1	1	0	7	70
9	1536	304	2	1	1	0	7	173
16	1360	288	5	0	7	100
16	1504	272	5	0	7	55
16	1504	288	5	0	7	10
16	1504	304	5	0	7	159
16	1504	320	5	0	7	24
#CELL 0 8
18	1552	304	16	0	8	195
9	1728	288	2	1	1	2	0	8	52
9	1728	304	2	1	1	0	8	150
9	1728	320	2	1	1	0	8	30
#CELL 0 5
3	1072	320	4	2	2	0	5	128
#CELL 1 2
18	368	320	16	1	2	67
18	560	352	16	1	2	124
9	384	336	2	1	1	1	2	11
9	400	336	2	1	1	1	2	133
9	416	336	2	1	1	1	2	73
9	432	336	2	1	1	1	2	141
9	448	336	2	1	1	1	2	111
#CELL 1 10
19	2080	390	17	1	10	41
5	1920	400	22	8	2	1	10	92
5	2032	249	22	1	10	1	10	21
5	1972	368	22	3	2	1	10	118
5	2064	416	22	32	1	1	10	95
7	1936	336	14	2	4	1	0	0	1	10	138
#CELL 1 1
18	368	320	16	1	1	67
9	224	352	2	1	1	1	1	99
9	240	352	2	1	1	1	1	35
9	256	352	2	1	1	1	1	94
9	272	352	2	1	1	1	1	103
9	384	336	2	1	1	1	1	11
#CELL 1 3
18	560	352	16	1	3	124
18	592	352	16	1	3	158
18	752	336	16	1	3	64
9	640	368	2	1	1	1	3	62
9	656	368	2	1	1	1	3	157
9	752	320	2	1	1	1	3	37
9	752	336	2	1	1	1	3	123
9	752	352	2	1	1	1	3	129
9	752	368	2	1	1	1	3	178
9	768	368	2	1	1	1	3	116
#CELL 1 4
18	752	336	16	1	4	64
9	768	368	2	1	1	1	4	116
9	784	368	2	1	1	1	4	190
9	800	368	2	1	1	1	4	42
9	864	336	2	1	1	1	4	88
9	864	352	2	1	1	1	4	106
9	864	368	2	1	1	1	4	40
9	864	384	2	1	1	1	4	142
9	880	384	2	1	1	1	4	48
9	896	384	2	1	1	1	4	46
9	944	336	2	1	1	1	4	5
9	944	352	2	1	1	1	4	90
9	960	352	2	1	1	4	1	4	170
9	960	400	2	1	1	1	4	6
#CELL 1 5
18	1088	384	16	1	5	145
9	960	352	2	1	1	4	1	5	170
9	960	400	2	1	1	1	5	6
9	976	400	2	1	1	1	5	193
9	992	400	2	1	1	1	5	148
9	1008	400	2	1	1	1	5	29
9	1008	352	2	1	1	2	1	5	23
9	1024	352	2	1	1	1	5	84
9	1040	352	2	1	1	1	5	154
9	1056	352	2	1	1	1	5	156
9	1072	352	2	1	1	1	5	166
9	1152	384	2	1	1	1	5	176
9	1168	384	2	1	1	1	5	131
3	1072	320	4	2	2	1	5	128
#CELL 1 6
18	1200	320	16	1	6	81
9	1168	384	2	1	1	1	6	131
9	1184	384	2	1	1	1	6	144
9	1200	384	2	1	1	1	6	39
9	1216	384	2	1	1	1	6	26
9	1264	368	2	1	1	1	6	104
9	1280	368	2	1	1	1	6	130
#CELL 1 7
18	1376	352	16	1	7	161
18	1408	336	16	1	7	91
9	1536	368	2	1	1	1	7	97
9	1536	384	2	1	1	1	7	36
9	1536	400	2	1	1	1	7	155
9	1552	400	2	1	1	1	7	167
16	1504	320	5	1	7	24
16	1504	336	5	1	7	83
16	1504	352	5	1	7	2
16	1504	368	5	1	7	20
16	1504	384	5	1	7	196
#CELL 1 8
18	1744	384	16	1	8	27
9	1552	400	2	1	1	1	8	167
9	1568	400	2	1	1	1	8	174
9	1584	400	2	1	1	1	8	31
9	1728	320	2	1	1	1	8	30
#CELL 1 9
18	1744	384	16	1	9	27
18	1776	336	16	1	9	191
18	1792	416	16	1	9	4
5	1920	400	22	8	2	1	9	92
7	1936	336	14	2	4	1	0	0	1	9	138
9	1776	368	2	1	1	1	9	7
9	1792	368	2	1	1	1	9	57
9	1808	368	2	1	1	1	9	87
#CELL 1 0
5	0	352	22	10	1	1	0	102
5	144	368	22	1	4	1	0	153
#CELL 1 11
5	2064	416	22	32	1	1	11	95
7	2192	384	14	2	2	0	0	1	-1	1	11	112
#CELL 1 12
5	2064	416	22	32	1	1	12	95
17	2448	336	5	1	12	17
#CELL 1 13
5	2064	416	22	32	1	1	13	95
[CELL_SIZE]
195	328
