[MAP]
3328	656	285	262
[OBJECTS]
# type: 0 = Mario , 1 = Brick, 2 = Goomba, 3 = Koopas,4 = Flower, 5 = Ground, 6 = ColorBox, 7 = Pipe, 8 = QuestionBrick, 9 = WeakBreak, 10 = CloundBrick, 11 = Item, 12 = Bullet, 13 = Effects
# KOOPAS
# BOMERANG BROTHER
19	2080	390	17	16	24


# MOVING WOOD
18	368	320	16	48	16

18	560	352	16	48	16
18	592	352	16	48	16
18	624	304	16	48	16


18	752	336	16	48	16

18	1088	384	16	48	16
					
18	1200	320	16	48	16
					
18	1376	352	16	48	16
18	1408	336	16	48	16
					
18	1552	304	16	48	16
					
18	1744	384	16	48	16
					
18	1776	336	16	48	16
					
18	1792	416	16	48	16

# Ground
5	0	352	22	10	1	160	16
5	144	368	22	1	4	16	64
5	1920	400	22	8	2	128	32
5	2032	249	22	1	10	16	160
5	1972	368	22	3	2	68	32
5	2064	416	22	32	1	512	16

# pipe
7	1936	336	14	2	4	1	0	0	32	64
7	2192	384	14	2	2	0	0	1	-1	32	32

# Weak Brick
9	224	352	2	1	1	16	16
9	240	352	2	1	1	16	16
9	256	352	2	1	1	16	16
9	272	352	2	1	1	16	16

9	384	336	2	1	1	16	16
9	400	336	2	1	1	16	16
9	416	336	2	1	1	16	16
9	432	336	2	1	1	16	16
9	448	336	2	1	1	16	16

9	608	288	2	1	1	16	16
9	624	288	2	1	1	16	16
9	640	288	2	1	1	3	16	16
9	656	288	2	1	1	16	16

9	640	368	2	1	1	16	16
9	656	368	2	1	1	16	16

9	752	320	2	1	1	16	16
9	752	336	2	1	1	16	16
9	752	352	2	1	1	16	16

9	752	368	2	1	1	16	16
9	768	368	2	1	1	16	16
9	784	368	2	1	1	16	16
9	800	368	2	1	1	16	16

9	864	336	2	1	1	16	16
9	864	352	2	1	1	16	16
9	864	368	2	1	1	16	16

9	864	384	2	1	1	16	16
9	880	384	2	1	1	16	16
9	896	384	2	1	1	16	16

9	944	336	2	1	1	16	16
9	944	352	2	1	1	16	16
9	960	352	2	1	1	4	16	16

9	960	400	2	1	1	16	16
9	976	400	2	1	1	16	16
9	992	400	2	1	1	16	16
9	1008	400	2	1	1	16	16

9	1008	352	2	1	1	2	16	16
9	1024	352	2	1	1	16	16
9	1040	352	2	1	1	16	16
9	1056	352	2	1	1	16	16
9	1072	352	2	1	1	16	16
							
9	1152	384	2	1	1	16	16
9	1168	384	2	1	1	16	16
9	1184	384	2	1	1	16	16
9	1200	384	2	1	1	16	16
9	1216	384	2	1	1	16	16
							
9	1184	304	2	1	1	16	16
9	1200	304	2	1	1	16	16
9	1216	304	2	1	1	16	16
9	1232	304	2	1	1	16	16

9	1232	288	2	1	1	3	16	16

9	1264	368	2	1	1	16	16
9	1280	368	2	1	1	16	16
							
9	1392	304	2	1	1	16	16
9	1408	304	2	1	1	16	16
9	1424	304	2	1	1	16	16
							
9	1536	288	2	1	1	16	16
9	1536	304	2	1	1	16	16
							
9	1536	368	2	1	1	16	16
9	1536	384	2	1	1	16	16
							
9	1536	400	2	1	1	16	16
9	1552	400	2	1	1	16	16
9	1568	400	2	1	1	16	16
9	1584	400	2	1	1	16	16

9	1728	288	2	1	1	2	16	16
9	1728	304	2	1	1	16	16
9	1728	320	2	1	1	16	16

9	1776	368	2	1	1	16	16
9	1792	368	2	1	1	16	16
9	1808	368	2	1	1	16	16

# COIN
16	336	304	5	16	16
16	352	304	5	16	16
16	368	304	5	16	16
				
16	416	272	5	16	16
16	432	272	5	16	16
16	448	272	5	16	16

16	1328	288	5	16	16
16	1344	288	5	16	16
16	1360	288	5	16	16
					
16	1504	272	5	16	16
16	1504	288	5	16	16
16	1504	304	5	16	16
16	1504	320	5	16	16
16	1504	336	5	16	16
16	1504	352	5	16	16
16	1504	368	5	16	16
16	1504	384	5	16	16
					
16	1888	304	5	16	16
16	1904	304	5	16	16
16	1920	304	5	16	16

# koopas
3	1866	295	4	6	2	16	28

3	1072	320	4	2	2	16	28

3	1984	300	4	2	2	16	28

# ITEM END GAME=====================================
17	2448	336	5	16	16